int wMap[3][3][15][15] = {{{{10,10,10,10,10,10,10,10,10,10,10,10,10,10,10}, //L Room 3
                            {10,14,14,14,14,14,14,14,14,14,14,14,14,14,10},
                            {10,14,14,14,14,0,0,0,0,0,0,14,14,14,10},
                            {10,14,14,0,0,0,0,0,0,0,0,0,14,14,10},
                            {10,14,0,0,0,0,0,0,0,0,0,0,14,14,10},
                            {10,14,0,0,0,0,0,0,0,0,0,0,14,14,10},
                            {10,14,0,0,0,0,0,0,0,0,0,0,0,14,10},
                            {10,14,0,0,0,0,0,0,0,0,0,0,0,0,0},
                            {10,14,0,0,0,0,0,0,0,0,0,0,0,14,10},
                            {10,14,0,0,0,0,0,0,0,0,0,0,14,14,10},
                            {10,14,0,0,0,0,0,0,0,0,0,0,14,14,10},
                            {10,14,14,0,0,0,0,0,0,0,0,0,14,14,10},
                            {10,14,14,14,14,0,0,0,0,0,0,14,14,14,10},
                            {10,14,14,14,14,14,14,14,14,14,14,14,14,14,10},
                            {10,10,10,10,10,10,10,10,10,10,10,10,10,10,10}},
                         
                           {{10,10,10,10,10,10,10,10,10,10,10,10,10,10,10}, //T Room 3
                            {10,5,5,5,5,5,5,5,5,5,5,5,5,5,10},
                            {10,5,0,0,0,0,0,0,0,0,0,0,0,5,10},
                            {10,5,0,0,0,0,0,0,0,0,0,0,0,5,10},
                            {10,5,0,0,0,5,5,0,0,5,5,0,0,5,10},
                            {10,5,0,0,0,5,5,0,0,5,5,0,0,5,10},
                            {10,0,0,0,0,0,0,0,0,0,0,0,0,0,0},
                            {10,0,0,0,0,0,0,0,0,0,0,0,0,0,0},
                            {10,0,0,0,0,0,0,0,0,0,0,0,0,0,0},
                            {10,5,0,0,0,5,5,0,0,5,5,0,0,5,10},
                            {10,5,0,0,0,5,5,0,0,5,5,0,0,5,10},
                            {10,5,0,0,0,0,0,0,0,0,0,0,0,5,10},
                            {10,5,0,0,0,0,0,0,0,0,0,0,0,5,10},
                            {10,5,5,5,5,5,5,5,5,5,5,5,5,5,10},
                            {10,10,10,10,10,10,10,10,10,10,10,10,10,10,10}},
                            
                           {{10,10,10,10,10,10,10,10,10,10,10,10,10,10,10}, //D Room 3
                            {10,0,0,0,0,0,0,0,0,0,0,0,0,0,10},
                            {10,0,3,0,3,0,0,0,0,0,3,0,3,0,10},
                            {10,0,0,0,0,0,0,0,0,0,0,0,0,0,10},
                            {10,0,0,0,0,10,3,0,3,2,0,0,0,0,10},
                            {10,0,0,0,10,10,0,0,0,2,2,0,0,0,10},
                            {10,0,0,10,10,10,0,0,0,2,2,2,0,0,10},
                            {10,0,0,10,10,10,0,0,3,2,2,2,0,0,0},
                            {10,0,0,10,10,10,0,0,0,2,2,2,0,0,10},
                            {10,0,0,0,10,10,0,0,0,2,2,0,0,0,10},
                            {10,0,0,0,0,10,3,0,3,2,0,0,0,0,10},
                            {10,0,0,0,0,0,0,0,0,0,0,0,0,0,10},
                            {10,0,3,0,3,0,0,0,0,0,3,0,3,0,10},
                            {10,0,0,0,0,0,0,0,0,0,0,0,0,0,10},
                            {10,10,10,10,10,10,10,10,10,10,10,10,10,10,10}}},

                          {{{10,10,10,10,10,10,10,10,10,10,10,10,10,10,10}, //L Room 2
                            {10,0,0,0,0,0,0,0,0,0,0,0,0,0,10},
                            {10,0,0,0,0,14,14,14,14,14,14,14,0,0,10},
                            {10,0,0,0,0,0,14,14,14,14,14,14,14,0,10},
                            {10,0,0,14,14,0,0,14,10,14,14,14,14,0,10},
                            {10,0,14,14,14,14,0,0,10,10,14,14,14,0,10},
                            {10,14,14,14,14,14,10,0,0,10,0,14,14,0,10},
                            {0,0,0,0,0,0,0,0,0,10,0,1,1,0,0},
                            {10,14,14,14,14,14,10,0,0,10,0,14,14,0,10},
                            {10,0,14,14,14,14,0,0,10,10,14,14,14,0,10},
                            {10,0,0,14,14,0,0,14,10,14,14,14,14,0,10},
                            {10,0,0,0,0,0,14,14,14,14,14,14,14,0,10},
                            {10,0,0,0,0,14,14,14,14,14,14,14,0,0,10},
                            {10,0,0,0,0,0,0,0,0,0,0,0,0,0,10},
                            {10,10,10,10,10,10,10,10,10,10,10,10,10,10,10}},
                            
                           {{10,10,10,10,10,10,10,10,10,10,10,10,10,10,10}, //T Room 2
                            {10,15,15,15,15,15,15,15,15,15,15,15,15,15,10},
                            {10,15,15,15,15,15,15,15,15,15,15,15,15,15,10},
                            {10,15,15,15,15,15,15,15,15,15,15,15,15,15,10},
                            {10,1,1,15,15,15,15,15,15,15,15,15,15,15,10},
                            {10,1,1,1,15,15,15,15,15,15,15,15,15,15,10},
                            {10,1,1,1,1,1,1,1,1,1,1,1,1,1,10},
                            {0,0,0,0,0,0,0,0,0,0,0,0,0,0,0},
                            {10,1,1,1,1,1,1,1,1,1,1,1,1,1,10},
                            {10,1,1,1,15,15,15,15,15,15,15,15,15,15,10},
                            {10,1,1,15,15,15,15,15,15,15,15,15,15,15,10},
                            {10,15,15,15,15,15,15,15,15,15,15,15,15,15,10},
                            {10,15,15,15,15,15,15,15,15,15,15,15,15,15,10},
                            {10,15,15,15,15,15,15,15,15,15,15,15,15,15,10},
                            {10,10,10,10,10,10,10,10,10,10,10,10,10,10,10}},

                           {{10,10,10,10,10,10,10,10,10,10,10,10,10,10,10}, //D Room 2
                            {10,0,0,3,3,3,3,3,3,3,3,3,0,0,10},
                            {10,0,0,0,3,3,3,3,3,3,3,0,0,0,10},
                            {10,0,0,0,0,3,3,3,3,3,0,0,0,0,10},
                            {10,0,3,0,0,0,3,3,3,0,0,0,3,0,10},
                            {10,0,0,0,0,0,0,0,0,0,0,0,0,0,10},
                            {10,0,0,0,0,0,0,0,0,0,0,0,0,0,10},
                            {0,0,0,0,0,0,3,0,3,0,0,0,0,0,0},
                            {10,0,0,0,2,0,0,0,0,0,2,0,0,0,10},
                            {10,0,0,2,2,2,0,0,0,2,2,2,0,0,10},
                            {10,0,0,0,2,0,0,0,0,0,2,0,0,0,10},
                            {10,0,0,0,0,0,0,0,0,0,0,0,0,0,10},
                            {10,0,0,0,0,0,0,3,0,0,0,0,0,0,10},
                            {10,0,0,0,0,0,0,0,0,0,0,0,0,0,10},
                            {10,10,10,10,10,10,10,10,10,10,10,10,10,10,10}}},

                          {{{10,10,10,10,10,10,10,10,10,10,10,10,10,10,10}, //L Room 1
                            {10,14,14,14,0,0,0,0,0,0,0,14,14,14,10},
                            {10,14,14,0,0,0,0,0,0,0,0,0,14,14,10},
                            {10,14,0,0,0,0,0,0,0,0,0,0,0,14,10},
                            {10,0,0,0,10,0,0,0,0,0,10,0,0,0,10},
                            {10,0,0,0,0,0,0,10,0,0,0,0,0,0,10},
                            {10,0,0,0,0,0,14,14,14,0,0,0,0,0,10},
                            {0,0,0,0,0,10,14,14,14,10,0,0,0,0,10},
                            {10,0,0,0,0,0,14,14,14,0,0,0,0,0,10},
                            {10,0,0,0,0,0,0,10,0,0,0,0,0,0,10},
                            {10,0,0,0,10,0,0,0,0,0,10,0,0,0,10},
                            {10,14,0,0,0,0,0,0,0,0,0,0,0,14,10},
                            {10,14,14,0,0,0,0,0,0,0,0,0,14,14,10},
                            {10,14,14,14,0,0,0,0,0,0,0,14,14,14,10},
                            {10,10,10,10,10,10,10,0,10,10,10,10,10,10,10}},

                           {{10,10,10,10,10,10,10,0,10,10,10,10,10,10,10}, //T Room 1
                            {10,0,0,0,0,0,0,0,0,0,0,0,0,0,10},
                            {10,0,0,0,0,0,0,0,0,0,0,0,0,0,10},
                            {10,0,0,0,0,0,0,0,0,0,0,0,0,0,10},
                            {10,0,0,0,0,0,0,0,0,0,0,0,0,0,10},
                            {10,0,0,0,0,0,0,0,0,0,0,0,0,0,10},
                            {10,0,0,0,0,0,0,0,0,0,0,0,0,0,10},
                            {0,0,0,0,0,0,0,0,0,0,0,0,0,0,0},
                            {10,0,0,0,0,0,0,0,0,0,0,0,0,0,10},
                            {10,0,0,0,0,0,0,0,0,0,0,0,0,0,10},
                            {10,0,0,0,0,0,0,0,0,0,0,0,0,0,10},
                            {10,0,0,0,0,0,0,0,0,0,0,0,0,0,10},
                            {10,0,0,0,0,0,0,0,0,0,0,0,0,0,10},
                            {10,0,0,0,0,0,0,0,0,0,0,0,0,0,10},
                            {10,10,10,10,10,10,10,0,10,10,10,10,10,10,10}},

                           {{10,10,10,10,10,10,10,0,10,10,10,10,10,10,10}, //D Room 1
                            {10,0,0,0,0,0,0,0,0,0,0,0,0,0,10},
                            {10,0,0,0,0,0,0,0,0,0,0,0,0,0,10},
                            {10,0,0,3,0,0,0,0,0,0,0,3,0,0,10},
                            {10,0,0,0,0,0,0,0,0,0,0,0,0,0,10},
                            {10,0,0,0,0,0,0,10,0,0,0,0,0,0,10},
                            {10,0,0,0,0,0,10,10,10,0,0,0,0,0,10},
                            {0,0,0,3,0,10,10,10,10,10,0,3,0,0,10},
                            {10,0,0,0,0,0,10,10,10,0,0,0,0,0,10},
                            {10,0,0,0,0,0,0,10,0,0,0,0,0,0,10},
                            {10,0,0,0,0,0,0,0,0,0,0,0,0,0,10},
                            {10,0,0,3,0,0,0,0,0,0,0,3,0,0,10},
                            {10,0,0,0,0,0,0,0,0,0,0,0,0,0,10},
                            {10,0,0,0,0,0,0,0,0,0,0,0,0,0,10},
                            {10,10,10,10,10,10,10,10,10,10,10,10,10,10,10}}}};
